5
10
##########
#@...a..A#
#b..a....#
#B.....A.#
##########