10
10
..........
@ab....A..
..........
..B.......
..........
..........
.........c
..........
.D........
........cC