8
6
.####.
#...#.
#.@c#.
##c.##
##.c.#
#Cc..#
#CC$C#
######
