7
8
..######
..#....#
###ccc.#
#..cCC.#
#@cCCC##
####..#.
...####.
