12
11
########...
#..#...#...
#...c..#...
#.c##.#####
##.#C.##..#
.#.#C...c.#
.#.#C.##..#
.#.#C###.##
.#@...##..#
.##.c.....#
..######..#
.......####
