9
8
######..
#C#..##.
#CCC..##
#.#$...#
#.c&#..#
##.c.c.#
.#c.c.##
.#...##.
.#####..
